Escape From The Cheerful Tortoise
An Interactive Fiction by Mackenzie Norman
Release 1 / Serial number 250430 / Inform 7 v10.1.2 / D

Darkness
It is pitch dark, and you can't see a thing.

You wake up, head pounding. The room smells of vomit and cleaning supplies. You can feel a string tickling your forehead.

>feel
What do you want to feel?

>feel string
You can't see any such thing.

>string
That's not a verb I recognise.

>pull string
You can't see any such thing.

>string
That's not a verb I recognise.

* * *

>feel
What do you want to feel?

>string
You can't see any such thing.

>purloin string
[Purloined.]

>e
You can't go that way.

storage closet

>i
You are carrying:
  a string you can feel (providing light)

>look
storage closet

* * *

Escape From The Cheerful Tortoise
An Interactive Fiction by Mackenzie Norman
Release 1 / Serial number 250430 / Inform 7 v10.1.2 / D

Darkness
It is pitch dark, and you can't see a thing.

You wake up, head pounding. The room smells of vomit and cleaning supplies. You can feel a string tickling your forehead.

>flip light switch
You can't see any such thing.

>flip light switch
You can't see any such thing.

>flip on light switch
You can't see any such thing.

* * *

Escape From The Cheerful Tortoise
An Interactive Fiction by Mackenzie Norman
Release 1 / Serial number 250430 / Inform 7 v10.1.2 / D

Darkness
It is pitch dark, and you can't see a thing.

You wake up, head pounding. The room smells of vomit and cleaning supplies. You can feel a string tickling your forehead.

>flip switch
You can't see any such thing.

>flip switch
You can't see any such thing.

>look
Darkness
It is pitch dark, and you can't see a thing.

>flip light-switch
You switch the light-switch on.

storage closet
You wake up, head pounding. The room smells of vomit and cleaning supplies.

You can see a light-switch here.

* * *

Escape From The Cheerful Tortoise
An Interactive Fiction by Mackenzie Norman
Release 1 / Serial number 250430 / Inform 7 v10.1.2 / D

Darkness
It is pitch dark, and you can't see a thing.

You wake up, head pounding. The room smells of vomit and cleaning supplies. You can feel a string tickling your forehead.

>light lightbulb
You can't see any such thing.

>lightbulb
That's not a verb I recognise.

* * *

Escape From The Cheerful Tortoise
An Interactive Fiction by Mackenzie Norman
Release 1 / Serial number 250430 / Inform 7 v10.1.2 / D

Darkness
It is pitch dark, and you can't see a thing.

You wake up, head pounding. The room smells of vomit and cleaning supplies. You can feel a string tickling your forehead.

>lightbulb
That's not a verb I recognise.

>light lightbulb
You can't see any such thing.

* * *

>lightbulb
That's not a verb I recognise.

>x
What do you want to examine?

>x lightbulb
You can't see any such thing.

>purloin lightbulb
[Purloined.]

>purloin string
[Purloined.]

I beg your pardon?

>i
You are carrying:
  a string you can (providing light)
  a lightbulb

storage closet

* * *

Escape From The Cheerful Tortoise
An Interactive Fiction by Mackenzie Norman
Release 1 / Serial number 250430 / Inform 7 v10.1.2 / D

Darkness
It is pitch dark, and you can't see a thing.

You wake up, head pounding. The room smells of vomit and cleaning supplies. You can feel a string tickling your forehead.

>look
Darkness
It is pitch dark, and you can't see a thing.

>e
hallway
Big Buck Hunter: Reloaded  glows in the distance. The hallway runs north, spilling out to a bar. The mens room door is to the east .

>end
That's not a verb I recognise.

* * *

>look
Darkness
It is pitch dark, and you can't see a thing.

>examine
What do you want to examine?

>x me
As good-looking as ever.

* * *

>look
Darkness
It is pitch dark, and you can't see a thing.

>pull string
You fumble for the string but find you can't get hold of it. You must need another drink.

>pull string
You switch the string on.

storage closet
God the lights are bright.  You are in a musty storage closet. There is a door to the east.

You can see a string here.

>e
hallway
Big Buck Hunter: Reloaded  glows in the distance. The hallway runs north, spilling out to a bar. The mens room door is to the east .

>n
bar
You're in the Cheerful Tortoise, the last thing you remember is asking the bartender for the code to the bathroom. It was something current.

With a capital Z crudely drawn to his collared shirt, Draug looks haggard and tired.

>talk to draug
Draug looks at you, eyes pleading. I've been trapped here for months. After I stole Edwards Zyn log as we were leaving that party, they trapped me in here until I can make up the difference.

I only need 5 more, please if you have any I'd trade you a quarter

>look bar
You can't see any such thing.

>x draug
You see nothing special about Draug.

>i
You are carrying nothing.

>s
hallway
Big Buck Hunter: Reloaded  glows in the distance. The hallway runs north, spilling out to a bar. The mens room door is to the east .

>x buck hunter
Cutscenes of deer running, then dying play on the screen. In the corner you see: 50/75 cents.

>e
mens room
You are in the mens room. It smells like barf and urine. The urinal, right next to sink has caution tape on it but based on the smell it hasn't stopped much.

>look urinal
Five Zyns in here. Pretty good bar

>take zyn
Taken.

>w
hallway
Big Buck Hunter: Reloaded  glows in the distance. The hallway runs north, spilling out to a bar. The mens room door is to the east .

>n
bar
You're in the Cheerful Tortoise, the last thing you remember is asking the bartender for the code to the bathroom. It was something current.

With a capital Z crudely drawn to his collared shirt, Draug looks haggard and tired.

>give zyn to draug
Draug starts crying

-  thank you so much!

he walks away, muttering "Sarahedolo is never gonna believe this".

>s
hallway
Big Buck Hunter: Reloaded  glows in the distance. The hallway runs north, spilling out to a bar. The mens room door is to the east .

* * *

>x buck hunter
Cutscenes of deer running, then dying play on the screen. In the corner you see: 50/75 cents.

>put quarter in buck hunter
You put the quarter into the Big Buck Hunter. You grab the plastic rifle, a mimicry of a phallus. Taking aim as the first doe crossing your screen - the crosshair lazily follows where you point

    *** a flash of light. You are no longer the hunter, you feel a reddish circle burn your skin, err hide. You are the doe and you are trapped. You see Draugs face through the glass. Looking grimly. It ends ***

Would you like to RESTART, RESTORE a saved game, QUIT or UNDO the last command?

* * *

>pull string
You switch the string on.

storage closet
God the lights are bright.  You are in a musty storage closet. There is a door to the east.

You can see a string here.

>pull string
You fumble for the string but find you can't get hold of it. You must need another drink.

>look
Darkness
It is pitch dark, and you can't see a thing.

You wake up, head pounding. The room smells of vomit and cleaning supplies. You can feel a string tickling your forehead.

>pull string
You switch the string on.

storage closet
You are in a musty storage closet. There is a door to the east.

You can see a string here.

>pull string
You switch the string off.

It is now pitch dark in here!

>e
hallway
Big Buck Hunter: Reloaded  glows in the distance. The hallway runs north, spilling out to a bar. The mens room door is to the east .

* * *

>n
bar
You're in the Cheerful Tortoise, the last thing you remember is asking the bartender for the code to the bathroom. It was something current.

With a capital Z crudely drawn to his collared shirt, Draug looks haggard and tired.

>lookdraug
That's not a verb I recognise.

>look draug
You see nothing special about Draug.

>talk to draug
Draug looks at you, pleading. I've been trapped here for months. After I stole Edwards Zyn log as we were leaving that party, they trapped me in here until I can make up the difference.

I only need 5 more, please if you have any I'd trade you a quarter

>n
You can't go that way.

>s
hallway
Big Buck Hunter: Reloaded  glows in the distance. The hallway runs north, spilling out to a bar. The mens room door is to the east .

>look big buck hunter
Cutscenes of deer running, then dying play on the screen. In the corner you see: 50/75 cents.

>e
mens room
You are in the mens room. It smells like barf and urine. The urinal, right next to sink has caution tape on it but based on the smell it hasn't stopped much.

* * *

>look urinal
Five Zyns in here. Pretty good bar

>take zyns
You can't see any such thing.

>take zyn
Taken.

>look
mens room
You are in the mens room. It smells like barf and urine. The urinal, right next to sink has caution tape on it but based on the smell it hasn't stopped much.

>look urinal
Five Zyns in here. Pretty good bar

>s
You can't go that way.

>w
hallway
Big Buck Hunter: Reloaded  glows in the distance. The hallway runs north, spilling out to a bar. The mens room door is to the east .

* * *

>n
bar
You're in the Cheerful Tortoise, the last thing you remember is asking the bartender for the code to the bathroom. It was something current.

With a capital Z crudely drawn to his collared shirt, Draug looks haggard and tired.

>give draug zyn
Draug starts crying

-  thank you so much!

he walks away, muttering "Sarahedolo is never gonna believe this".

>talk to draug
You can't see any such thing.

>e
You can't go that way.

>s
hallway
Big Buck Hunter: Reloaded  glows in the distance. The hallway runs north, spilling out to a bar. The mens room door is to the east .

>put quarter in big buck hunter
You put the quarter into the Big Buck Hunter. You grab the plastic rifle, a mimicry of a phallus. Taking aim as the first doe crossing your screen - the crosshair lazily follows where you point

    *** a flash of light. You are no longer the hunter, you feel a reddish circle burn your skin, err hide. You are the doe and you are trapped. You see Draugs face through the glass. Looking grimly. It ends ***

Would you like to RESTART, RESTORE a saved game, QUIT or UNDO the last command?

* * *

Escape From The Cheerful Tortoise
An Interactive Fiction by Mackenzie Norman
Release 1 / Serial number 250430 / Inform 7 v10.1.2 / D

Darkness
It is pitch dark, and you can't see a thing.

You wake up, head pounding. The room smells of vomit and cleaning supplies. You can feel a string tickling your forehead.

>n
hallway

>look
hallway

* * *

Escape From The Cheerful Tortoise
An Interactive Fiction by Mackenzie Norman
Release 1 / Serial number 250430 / Inform 7 v10.1.2 / D

Darkness
It is pitch dark, and you can't see a thing.

You wake up, head pounding. The room smells of vomit and cleaning supplies. You can feel a string tickling your forehead.

>north
hallway
Big Buck Hunter glows in the distance.

>examine
What do you want to examine?

>examine you
You can't see any such thing.

>x
What do you want to examine?

>x player
You can't see any such thing.

>i
You are carrying nothing.

* * *

Escape From The Cheerful Tortoise
An Interactive Fiction by Mackenzie Norman
Release 1 / Serial number 250430 / Inform 7 v10.1.2 / D

Darkness
It is pitch dark, and you can't see a thing.

You wake up, head pounding. The room smells of vomit and cleaning supplies. You can feel a string tickling your forehead.

>pull strign
You can't see any such thing.

>pull string
You switch the string on.

storage closet
God the lights are bright.  You are in a musty storage closet. There is a door to the east

You can see a string here.

>e
hallway
Big Buck Hunter: Reloaded  glows in the distance. The hallway runs north, spilling out to a bar. The mens room door is to the east .

* * *

>n
bar
You're in the Cheerful Tortoise, the last thing you remember is asking the bartender for the code to the bathroom. It was something current.

With a capital Z crudely drawn to his collared shirt, Draug looks haggard and tired.

>x bundle
You can't see any such thing.

>s
hallway
Big Buck Hunter: Reloaded  glows in the distance. The hallway runs north, spilling out to a bar. The mens room door is to the east .

>e
mens room
You are in the mens room. It smells like barf and urine. The urinal, right next to sink has caution tape on it but based on the smell it hasn't stopped much.

>x urinal
Five Zyns in here. Pretty good bar

>w
hallway
Big Buck Hunter: Reloaded  glows in the distance. The hallway runs north, spilling out to a bar. The mens room door is to the east .

* * *

>n
bar
You're in the Cheerful Tortoise, the last thing you remember is asking the bartender for the code to the bathroom. It was something current.

With a capital Z crudely drawn to his collared shirt, Draug looks haggard and tired.

>look draug
You see nothing special about Draug.

>talk draug
I didn't understand that sentence.

>talk to draug
Draug looks at you, pleading. I've been trapped here for months. After I stole Edwards Zyn log as we were leaving that party, they trapped me in here until I can make up the difference.

I only need 5 more, please if you have any I'd trade you a quarter

>give draug zyn
You can't see any such thing.

>zyn
That's not a verb I recognise.

>i
You are carrying nothing.

* * *

>e
mens room
You are in the mens room. It smells like barf and urine. The urinal, right next to sink has caution tape on it but based on the smell it hasn't stopped much.

>take zyn
Taken.

* * *

>n
bar
You're in the Cheerful Tortoise, the last thing you remember is asking the bartender for the code to the bathroom. It was something current.

With a capital Z crudely drawn to his collared shirt, Draug looks haggard and tired.

>talk to draug
Draug looks at you, pleading. I've been trapped here for months. After I stole Edwards Zyn log as we were leaving that party, they trapped me in here until I can make up the difference.

I only need 5 more, please if you have any I'd trade you a quarter

>give draug zyn
Draug starts crying

-  thank you so much!

he walks away, muttering "Sarahedolo is never gonna believe this".

>i
You are carrying:
  a quarter

>s
hallway
Big Buck Hunter: Reloaded  glows in the distance. The hallway runs north, spilling out to a bar. The mens room door is to the east .

>put quarter in big buck hunter
You put the quarter into the Big Buck Hunter. You grab the plastic rifle, a mimicry of a phallus. Taking aim as the first doe crossing your screen - the crosshair lazily follows where you point

* * *

Escape From The Cheerful Tortoise
An Interactive Fiction by Mackenzie Norman
Release 1 / Serial number 250430 / Inform 7 v10.1.2 / D

Darkness
It is pitch dark, and you can't see a thing.

You wake up, head pounding. The room smells of vomit and cleaning supplies. You can feel a string tickling your forehead.

>pull string
You switch the string on.

storage closet
God the lights are bright.  You are in a musty storage closet. There is a door to the east

You can see a string here.

>e
hallway
Big Buck Hunter: Reloaded  glows in the distance.

>look Big Buck Hunter
Cutscenes of deer running, then dying play on the screen. In the corner you see: 50/75 cents.

>x Big Buck Hunter
Cutscenes of deer running, then dying play on the screen. In the corner you see: 50/75 cents.

* * *

>e
hallway
Big Buck Hunter: Reloaded  glows in the distance.

>mens room
That's not a verb I recognise.

>e
mens room
You are in the mens room. It smells like barf and urine.

You can see five zyn here.

>take zyn
Taken.

>look
mens room
You are in the mens room. It smells like barf and urine.

>i
You are carrying:
  five zyn

>drop 1 zyn
Dropped.

>i
You are carrying nothing.

>take zyn
Taken.

>l
mens room
You are in the mens room. It smells like barf and urine.

>x
(five zyn)
You see nothing special about five zyn.

>look
mens room
You are in the mens room. It smells like barf and urine.

>w
hallway
Big Buck Hunter: Reloaded  glows in the distance.

>w
You can't go that way.

* * *

>e
hallway
Big Buck Hunter: Reloaded  glows in the distance.

>n
bar
You're in the cheerful tortoise, the last thing you remember is asking the bartender for the code to the bathroom. It was something current.

>look
bar
You're in the cheerful tortoise, the last thing you remember is asking the bartender for the code to the bathroom. It was something current.

>s
hallway
Big Buck Hunter: Reloaded  glows in the distance.

>e
mens room

* * *

>n
bar
You're in the cheerful tortoise, the last thing you remember is asking the bartender for the code to the bathroom. It was something current.

>s
hallway
Big Buck Hunter: Reloaded  glows in the distance.

* * *

>pull string
You switch the string on.

storage closet
God the lights are bright.  You are in a musty storage closet. There is a door to the east

You can see a string here.

>east
hallway
Big Buck Hunter glows in the distance.

* * *

>pull string
You switch the string on.

storage closet
God the lights are bright.  You are in a musty storage closet. There is a door to the east

You can see a string here.

>look
storage closet
You are in a musty storage closet.

You can see a string here.

>look
Darkness
It is pitch dark, and you can't see a thing.

>pull string
You switch the string on.

storage closet
You wake up, head pounding. The room smells of vomit and cleaning supplies. You can feel a string tickling your forehead. .

You can see a string here.

* * *

>pull string
You switch the string on.

storage closet
God the lights are bright.  You are in a musty storage closet. There is a door to the east

You can see a string here.

>pull string
You switch the string off.

It is now pitch dark in here!

>e
hallway
Big Buck Hunter glows in the distance.

50/75 cents

>look Big buck hunter
You see nothing special about Big Buck Hunter.

>look
hallway
Big Buck Hunter glows in the distance.

50/75 cents

* * *

>pull string
You switch the string off.

It is now pitch dark in here!

>pull string
You switch the string on.

storage closet
You are in a musty storage closet. There is a door to the east

You can see a string here.

>look
storage closet
You are in a musty storage closet.

You can see a string here.

>e
hallway
Big Buck Hunter glows in the distance.

* * *

>pull string
You switch the string on.

storage closet
You are in a musty storage closet. There is a door to the east

You can see a string here.

>pull string
You switch the string off.

It is now pitch dark in here!

* * *

>pull string
You switch the string on.

storage closet
You are in a musty storage closet. There is a door to the east

You can see a string here.

>e
hallway
Big Buck Hunter: Reloaded  glows in the distance. The hallway runs north, spilling out to a bar. The mens room door is to the east .

>look
hallway
Big Buck Hunter: Reloaded  glows in the distance. The hallway runs north, spilling out to a bar. The mens room door is to the east .

>look big buck hunter
Cutscenes of deer running, then dying play on the screen. In the corner you see: 50/75 cents.

>e
mens room
You are in the mens room. It smells like barf and urine.  there are five zyns in the urinal.

You can see a zyn here.

>take zyn
Taken.

>i
You are carrying:
  a zyn

>take zyn
You already have that.

* * *

>pull string
You switch the string on.

storage closet
God the lights are bright.  You are in a musty storage closet. There is a door to the east

You can see a string here.

>touch string
You can't see any such thing.

>string
That's not a verb I recognise.

>light
What do you want to light?

>string
You can't see any such thing.

>turn on light
You can't see any such thing.

* * *

Escape From The Cheerful Tortoise
An Interactive Fiction by Mackenzie Norman
Release 1 / Serial number 250430 / Inform 7 v10.1.2 / D

Darkness
It is pitch dark, and you can't see a thing.

You wake up, head pounding. The room smells of vomit and cleaning supplies. You can feel a string tickling your forehead.

>switch on
(the light switch)
That's already on.

>flip off
You can't see any such thing.

>flip switch off
You can't see any such thing.

>switch off
(the light switch)
You switch the light switch off.

It is now pitch dark in here!

>look
Darkness
It is pitch dark, and you can't see a thing.

* * *

Escape From The Cheerful Tortoise
An Interactive Fiction by Mackenzie Norman
Release 1 / Serial number 250430 / Inform 7 v10.1.2 / D

Darkness
It is pitch dark, and you can't see a thing.

You wake up, head pounding. The room smells of vomit and cleaning supplies. You can feel a string tickling your forehead.

>turn off light switch
You switch the light switch off.

It is now pitch dark in here!

>look
Darkness
It is pitch dark, and you can't see a thing.

>turn on light switch
You can't see any such thing.

>turn on lightswitch
You can't see any such thing.

* * *

Escape From The Cheerful Tortoise
An Interactive Fiction by Mackenzie Norman
Release 1 / Serial number 250430 / Inform 7 v10.1.2 / D

Darkness
It is pitch dark, and you can't see a thing.

You wake up, head pounding. The room smells of vomit and cleaning supplies. You can feel a string tickling your forehead.

>turn off switch
You switch the light switch off.

It is now pitch dark in here!

>look
Darkness
It is pitch dark, and you can't see a thing.

* * *

Escape From The Cheerful Tortoise
An Interactive Fiction by Mackenzie Norman
Release 1 / Serial number 250430 / Inform 7 v10.1.2 / D

Darkness
It is pitch dark, and you can't see a thing.

You wake up, head pounding. The room smells of vomit and cleaning supplies. You can feel a string tickling your forehead.

>turn on light switch
You can't see any such thing.

>turn on light switch
You can't see any such thing.

* * *

Escape From The Cheerful Tortoise
An Interactive Fiction by Mackenzie Norman
Release 1 / Serial number 250430 / Inform 7 v10.1.2 / D

Darkness
It is pitch dark, and you can't see a thing.

You wake up, head pounding. The room smells of vomit and cleaning supplies. You can feel a string tickling your forehead.

>turn on lightbulb
You can't see any such thing.